30,1,1,1,1,1,1,1,1,4,
24,0,0,0,0,0,0,0,0,24,
0,0,0,0,0,0,0,0,0,0,
0,0,1,1,1,1,1,1,0,0,
0,0,0,0,0,0,0,0,0,0,
0,0,0,0,0,0,0,0,0,0,
0,0,1,1,1,1,1,1,0,0,
0,0,0,0,0,0,0,0,0,0,
26,0,0,0,0,0,0,0,0,26,
28,1,1,1,1,1,1,1,1,29